N ./pared.xpm
S ./log.xpm
WE ./stone.xpm
EA ./wood.xpm

F 200, 100, 0
C 100, 34, 0

111111111111111
111111111111111
110000000000011
110000000000011
1100000N0000011
110000000000011
110000000000011
110000000000011
111111111111111
111111111111111
