N ./textures/pared.xpm
S ./textures/log.xpm

WE ./textures/stone.xpm
EA ./textures/wood.xpm

F 200, 100, 0
C 100, 34, 0

111111111111111
111111111111111
110000000000011
110000000000011
1100000S0000011
110000000000011
110000000000011
110000000000011
111111111111111
111111111111111
